,Number of frames,car_average_value,bus_average_value,truck_average_value,car_flow_count,bus_flow_count,truck_flow_count,all_flow_count
0,100,10.08,0.0,0.21,37,0,2,39
1,200,9.1,0.09,0.65,65,0,6,71
2,300,8.74,0.21,0.92,99,0,9,108
3,400,6.65,0.74,1.4,118,1,13,132
4,500,9.16,0.25,0.7,143,1,13,157
5,600,8.63,0.01,0.33,164,1,16,181
6,700,6.16,0.12,1.96,183,1,23,207
7,800,7.51,0.14,2.12,208,2,26,236
8,900,5.76,0.0,2.69,228,2,29,259
9,1000,8.34,0.0,1.04,252,2,32,286
10,1100,8.31,0.0,0.07,273,2,34,309
11,1200,9.23,0.0,0.64,301,2,36,339
12,1300,8.27,0.18,1.09,325,2,43,370
13,1400,7.2,0.04,1.5,340,2,48,390
14,1500,8.27,0.05,1.76,368,4,49,421
15,1600,10.35,0.02,0.29,400,4,51,455
16,1700,10.21,0.02,0.33,434,4,51,489
17,1800,8.4,0.59,0.65,450,5,56,511
18,1900,6.73,0.05,1.5,463,5,62,530
19,2000,7.54,0.7,2.09,487,9,65,561
20,2100,9.67,0.0,0.21,518,9,66,593
21,2200,9.5,0.01,0.14,541,9,69,619
22,2300,8.61,0.03,0.83,564,10,71,645
23,2400,9.49,0.12,0.94,587,11,80,678
24,2500,8.24,0.0,1.6,615,11,87,713
25,2600,10.35,0.0,0.07,639,11,88,738
26,2700,9.39,0.2,0.91,666,13,93,772
27,2800,8.01,0.74,0.51,687,13,94,794
28,2900,9.78,0.32,0.28,709,14,97,820
29,3000,10.18,0.11,0.81,735,15,101,851
30,3100,9.46,0.02,0.35,758,15,103,876
31,3200,9.64,0.09,0.59,785,15,103,903
32,3300,9.77,0.0,0.22,812,15,103,930
33,3400,8.86,0.0,1.17,833,15,107,955
34,3500,7.11,0.0,2.12,847,15,110,972
35,3600,8.96,0.14,1.19,876,15,114,1005
36,3700,9.9,0.04,0.78,898,15,116,1029
37,3800,8.39,0.0,1.54,920,15,119,1054
38,3900,9.86,0.03,0.58,946,15,121,1082
39,4000,8.43,1.08,0.33,973,17,121,1111
40,4100,9.62,0.27,0.13,1001,17,121,1139
41,4200,9.7,0.0,0.79,1031,17,127,1175
42,4300,8.83,0.0,1.06,1057,17,130,1204
43,4400,8.81,0.0,1.62,1083,17,132,1232
44,4500,8.73,0.0,1.19,1114,17,133,1264
45,4600,10.73,0.0,0.04,1146,17,134,1297
46,4700,9.02,0.65,0.87,1171,17,145,1333
47,4800,8.54,0.05,1.39,1199,18,145,1362
48,4900,8.16,0.18,1.29,1218,19,148,1385
49,5000,6.87,0.73,1.3,1241,20,150,1411
50,5100,10.32,0.05,0.25,1272,20,152,1444
51,5200,9.0,0.0,0.64,1301,20,153,1474
52,5300,8.68,0.0,0.01,1324,20,153,1497
53,5400,9.25,0.07,0.18,1348,21,154,1523
54,5500,9.29,0.75,0.13,1374,22,155,1551
55,5600,10.32,0.0,0.26,1409,22,157,1588
56,5700,10.7,0.0,1.15,1434,22,161,1617
57,5800,13.37,0.0,0.77,1457,22,161,1640
58,5900,11.89,0.11,0.15,1473,22,163,1658
59,6000,10.09,0.91,0.06,1494,23,163,1680
60,6100,9.58,0.63,0.05,1522,24,165,1711
61,6200,10.58,0.12,0.04,1547,24,166,1737
62,6300,10.31,0.0,0.25,1584,24,168,1776
63,6400,8.02,0.01,1.54,1611,24,170,1805
64,6500,7.67,0.07,0.81,1633,25,170,1828
65,6600,9.59,0.0,0.5,1659,25,175,1859
66,6700,8.86,0.0,0.34,1683,25,177,1885
67,6800,6.6,0.0,2.11,1698,25,180,1903
68,6900,6.94,0.08,2.03,1712,25,186,1923
69,7000,8.3,0.0,1.34,1737,25,187,1949
70,7100,10.53,0.0,0.15,1770,25,189,1984
71,7200,6.6,0.0,1.24,1784,25,192,2001
72,7300,9.16,0.0,0.98,1811,25,193,2029
73,7400,9.12,0.0,0.08,1836,25,194,2055
74,7500,8.15,0.01,0.51,1863,25,194,2082
75,7600,9.15,0.0,0.12,1889,25,194,2108
76,7700,10.29,0.0,0.05,1922,25,195,2142
77,7800,10.27,0.0,0.01,1951,25,196,2172
78,7900,10.54,0.0,0.25,1982,25,198,2205
79,8000,10.12,0.0,0.19,2008,25,199,2232
80,8100,10.97,0.18,0.05,2038,28,200,2266
81,8200,11.48,0.0,0.13,2070,28,200,2298
82,8300,9.78,0.0,1.05,2096,28,202,2326
83,8400,10.12,0.0,1.06,2115,28,202,2345
84,8500,9.62,0.35,0.01,2133,30,202,2365
85,8600,10.77,0.77,0.14,2163,31,203,2397
86,8700,10.02,0.0,0.63,2181,31,206,2418
87,8800,6.41,0.0,3.05,2212,31,214,2457
88,8900,10.45,0.65,1.57,2238,33,218,2489
89,9000,10.05,0.75,0.96,2253,33,220,2506
90,9100,6.4,0.0,2.6,2274,33,222,2529
91,9200,10.31,0.0,0.07,2295,33,222,2550
92,9300,9.92,0.06,1.3,2322,34,227,2583
93,9400,12.28,0.0,0.06,2349,34,227,2610
94,9500,12.35,0.0,0.09,2368,34,227,2629
95,9600,9.4,0.97,0.28,2393,37,227,2657
96,9700,8.42,0.57,1.21,2413,37,229,2679
97,9800,8.87,0.0,0.14,2444,37,230,2711
98,9900,9.56,0.0,0.12,2481,37,231,2749
99,10000,9.55,0.0,0.83,2503,37,234,2774
100,10100,8.14,0.06,1.97,2526,38,234,2798
101,10200,11.0,0.0,0.11,2551,38,235,2824
102,10300,9.99,0.19,0.6,2579,38,238,2855
103,10400,8.32,0.02,0.45,2601,38,242,2881
104,10500,8.48,0.0,1.45,2633,38,243,2914
105,10600,8.16,0.33,1.65,2648,39,248,2935
106,10700,8.79,0.19,0.99,2674,39,252,2965
107,10800,9.2,0.0,0.54,2704,39,253,2996
108,10900,8.36,0.5,0.03,2723,41,253,3017
109,11000,9.41,0.25,0.16,2758,41,254,3053
110,11100,9.31,0.0,0.65,2795,41,257,3093
111,11200,6.26,0.47,2.67,2809,41,259,3109
112,11300,6.33,0.3,2.04,2823,41,264,3128
113,11400,7.13,0.0,1.95,2843,41,267,3151
114,11500,10.5,0.0,0.06,2867,41,268,3176
115,11600,9.2,0.0,0.4,2893,41,268,3202
116,11700,9.86,0.0,0.13,2925,41,270,3236
117,11800,9.46,0.0,0.68,2954,41,273,3268
118,11900,8.06,0.17,1.39,2977,42,279,3298
119,12000,9.95,0.02,0.4,3004,43,282,3329
120,12100,8.05,0.01,1.65,3032,43,288,3363
121,12200,9.09,0.0,0.2,3064,43,288,3395
122,12300,8.71,0.16,0.0,3099,45,288,3432
123,12400,9.08,0.0,0.07,3132,45,288,3465
124,12500,7.14,0.0,0.04,3156,45,289,3490
125,12600,5.33,0.07,1.38,3174,45,292,3511
126,12700,7.82,0.28,0.85,3201,45,296,3542
127,12800,8.68,0.01,0.48,3241,46,299,3586
128,12900,8.03,0.0,0.88,3281,46,301,3628
129,13000,9.4,0.01,0.4,3325,46,302,3673
130,13100,8.66,0.0,0.15,3369,46,304,3719
131,13200,6.64,0.42,1.0,3406,47,306,3759
132,13300,5.93,0.0,1.48,3428,47,312,3787
133,13400,8.08,0.11,0.69,3461,48,315,3824
134,13500,8.4,0.47,1.05,3493,49,320,3862
135,13600,8.99,0.02,0.12,3530,49,322,3901
136,13700,9.51,0.0,0.82,3560,49,324,3933
137,13800,9.63,0.0,0.13,3596,49,326,3971
138,13900,7.67,0.0,1.11,3624,49,330,4003
139,14000,7.93,0.0,0.44,3657,49,331,4037
140,14100,5.48,0.01,0.77,3669,49,336,4054
141,14200,6.42,0.97,1.32,3698,52,339,4089
142,14300,8.73,0.54,0.26,3723,52,341,4116
143,14400,8.74,0.0,0.36,3753,52,344,4149
144,14500,8.0,0.31,1.17,3779,52,349,4180
145,14600,7.06,0.42,1.6,3813,55,354,4222
146,14700,8.48,0.2,0.83,3852,55,360,4267
147,14800,9.42,0.0,0.11,3889,55,360,4304
148,14900,8.9,0.0,0.29,3926,55,363,4344
149,15000,9.18,0.0,0.05,3966,55,364,4385
150,15100,8.27,0.0,0.74,4004,55,366,4425
151,15200,9.81,0.0,0.05,4037,55,366,4458
152,15300,9.26,0.0,0.05,4073,55,367,4495
153,15400,9.21,0.0,0.42,4109,55,372,4536
154,15500,6.34,0.04,1.62,4136,55,378,4569
155,15600,9.25,0.02,0.73,4167,55,382,4604
156,15700,8.05,0.74,0.61,4191,58,385,4634
157,15800,7.8,0.54,0.47,4219,58,388,4665
158,15900,7.7,0.0,0.15,4241,58,388,4687
159,16000,7.19,0.11,0.3,4266,59,390,4715
160,16100,8.76,0.75,0.47,4305,60,393,4758
161,16200,9.0,0.0,0.19,4343,60,395,4798
162,16300,7.94,0.17,0.94,4368,61,399,4828
163,16400,9.58,0.01,0.56,4411,61,400,4872
164,16500,7.22,0.44,0.19,4436,62,403,4901
165,16600,4.51,0.1,0.26,4453,62,404,4919
166,16700,7.79,0.0,0.75,4491,62,407,4960
167,16800,5.95,0.0,0.22,4512,62,410,4984
168,16900,4.27,0.06,0.75,4525,62,413,5000
169,17000,2.65,0.0,0.36,4533,62,414,5009
170,17100,6.46,0.55,1.19,4564,65,418,5047
171,17200,6.82,0.27,1.19,4591,66,423,5080
172,17300,8.01,0.15,0.85,4627,66,430,5123
173,17400,7.55,0.69,0.62,4661,66,434,5161
174,17500,6.74,0.02,0.79,4694,66,434,5194
175,17600,7.88,0.03,0.72,4722,66,438,5226
176,17700,2.87,0.0,0.77,4730,66,441,5237
177,17800,5.17,0.0,0.46,4755,66,442,5263
178,17900,6.57,0.51,0.83,4791,67,445,5303
179,18000,4.17,0.0,0.38,4808,67,445,5320
180,18100,3.78,0.02,0.6,4823,67,449,5339
181,18200,6.84,0.31,1.25,4858,69,451,5378
182,18300,7.3,0.16,0.29,4891,70,455,5416
183,18400,5.0,0.01,1.15,4916,70,458,5444
184,18500,5.76,0.42,0.71,4942,73,459,5474
185,18600,7.38,0.0,1.43,4977,73,462,5512
186,18700,5.94,0.4,0.86,5001,73,464,5538
187,18800,6.42,0.02,1.21,5033,73,471,5577
188,18900,7.37,0.0,0.13,5062,73,472,5607
189,19000,6.92,0.0,0.9,5092,73,476,5641
190,19100,5.02,0.0,0.62,5114,73,477,5664
191,19200,6.42,0.05,1.79,5147,73,484,5704
192,19300,6.34,0.18,1.24,5178,73,489,5740
193,19400,7.76,0.01,0.15,5210,73,489,5772
194,19500,6.64,0.04,0.91,5250,73,491,5814
195,19600,4.79,0.0,1.26,5270,73,495,5838
196,19700,7.19,0.41,0.26,5300,74,495,5869
197,19800,4.22,0.0,0.55,5313,74,497,5884
198,19900,4.29,0.0,0.44,5332,74,499,5905
199,20000,8.76,0.8,0.23,5373,77,499,5949
200,20100,5.09,0.11,0.88,5391,77,503,5971
201,20200,7.42,0.06,0.65,5422,77,506,6005
202,20300,8.16,0.43,0.17,5455,79,508,6042
203,20400,8.85,0.0,0.17,5485,79,510,6074
204,20500,3.57,0.39,1.1,5499,80,514,6093
205,20600,8.61,0.32,0.17,5541,81,515,6137
206,20700,5.05,0.11,0.55,5558,81,520,6159
207,20800,5.43,0.0,1.0,5580,81,522,6183
208,20900,5.51,0.0,0.74,5608,81,523,6212
209,21000,7.78,0.1,0.36,5645,83,527,6255
210,21100,2.38,0.37,0.62,5655,83,528,6266
211,21200,3.72,0.02,1.48,5667,83,531,6281
212,21300,6.58,0.01,1.1,5700,83,536,6319
213,21400,6.34,0.0,1.21,5731,83,539,6353
214,21500,3.36,0.27,1.27,5745,84,544,6373
215,21600,5.57,0.0,1.62,5773,84,548,6405
216,21700,8.17,0.44,0.22,5801,84,550,6435
217,21800,4.92,0.46,2.25,5822,87,555,6464
218,21900,6.92,0.54,1.08,5850,87,559,6496
219,22000,6.32,0.0,0.49,5885,87,559,6531
220,22100,6.69,0.0,0.26,5909,87,561,6557
221,22200,5.17,0.2,0.8,5929,87,566,6582
222,22300,3.83,0.24,1.43,5949,87,571,6607
223,22400,6.1,0.35,0.7,5974,88,573,6635
224,22500,7.3,0.01,0.74,6009,88,576,6673
225,22600,8.52,0.0,0.33,6043,88,578,6709
226,22700,6.42,0.0,0.33,6068,88,579,6735
227,22800,4.65,0.02,0.52,6086,88,581,6755
228,22900,3.94,0.0,1.31,6099,88,585,6772
229,23000,7.75,0.07,0.57,6130,89,588,6807
230,23100,9.16,0.45,0.08,6171,90,589,6850
231,23200,8.21,0.26,0.06,6201,90,591,6882
232,23300,5.47,0.2,0.66,6220,90,594,6904
233,23400,5.86,0.44,0.28,6241,91,594,6926
234,23500,5.19,0.0,0.43,6262,91,596,6949
235,23600,6.16,0.0,0.03,6286,91,596,6973
236,23700,5.16,0.0,0.99,6307,91,599,6997
237,23800,6.93,0.0,0.08,6335,91,601,7027
238,23900,6.18,0.0,0.35,6359,91,603,7053
239,24000,4.75,0.06,0.28,6379,91,604,7074
240,24100,4.63,0.03,0.71,6402,91,606,7099
241,24200,6.83,0.36,0.08,6435,92,608,7135
242,24300,5.51,0.42,1.28,6458,93,614,7165
243,24400,7.35,0.03,1.07,6492,93,617,7202
244,24500,7.15,0.0,0.84,6513,93,622,7228
245,24600,6.31,0.09,1.61,6542,93,628,7263
246,24700,6.07,0.01,1.7,6563,93,632,7288
247,24800,6.59,0.0,0.13,6586,93,633,7312
248,24900,4.87,0.03,0.8,6605,93,636,7334
249,25000,6.99,0.33,0.39,6637,94,637,7368
250,25100,8.82,0.4,0.39,6679,95,639,7413
251,25200,5.89,0.03,0.61,6709,95,643,7447
252,25300,3.73,0.0,2.02,6725,95,649,7469
253,25400,7.66,0.0,1.13,6765,95,653,7513
254,25500,7.67,0.0,0.4,6795,95,654,7544
255,25600,5.16,0.57,0.74,6817,95,657,7569
256,25700,7.96,0.0,0.31,6854,95,659,7608
257,25800,7.26,0.11,0.92,6886,95,664,7645
258,25900,7.42,1.21,2.13,6914,98,670,7682
259,26000,12.1,0.84,0.2,6951,98,670,7719
260,26100,8.17,0.08,1.95,6968,98,672,7738
261,26200,7.99,0.01,0.67,6990,98,674,7762
262,26300,7.81,0.22,0.56,7012,99,676,7787
263,26500,5.99,0.03,1.81,7030,99,683,7812
264,26600,7.56,0.01,0.78,7065,99,688,7852
265,26700,4.64,0.02,0.78,7083,99,691,7873
266,26800,3.51,0.0,0.45,7097,99,696,7892
267,26900,5.47,0.0,0.0,7120,99,696,7915
268,27000,2.13,0.0,0.0,7127,99,696,7922
269,27100,5.23,0.32,0.11,7151,101,696,7948
270,27200,3.24,0.0,0.21,7164,101,697,7962
271,27300,2.99,0.0,0.25,7174,101,697,7972
